- - # # # # # #
- # # - - - P #
# # - - - # O #
# O - B - B B #
# O O B - - - #
# # # # # # # #