- # # # # # # - - -
- # O - - O # - - -
# # - B B # # - - -
# - - - - # # - - -
# - B - - P # # # #
# # - - - - - - O #
- # # # # # # # # #